50
groundpound 40 down
3 3 3 3 3 3 3 3 3 3 3 3 3 3 3 i i i i i i 1 1 3 3 3 3 3 1 1 1 1 1 1 1 1 1 1 1 1 1 3 3 i i i i i i i i i i 3 3 3 3 3 3 3 3 i i i
3 3 3 3 3 3 3 3 3 3 3 3 3 3 3 i i i i i i 1 1 3 3 3 3 3 1 1 1 1 1 1 1 1 1 1 1 1 1 3 3 i i i i i i i i i i 3 3 3 3 3 3 3 3 i i i
0 0 0 0 0 0 0 0 0 0 0 0 0 0 0 i i i i i i 1 1 3 3 3 3 3 1 1 1 1 1 1 1 1 1 1 1 1 1 3 3 i i i i i i i i i i 3 3 3 3 3 3 3 3 i i i
0 0 0 0 0 0 0 0 0 0 0 0 0 0 0 i i i i i i 1 1 0 0 0 0 0 2 0 0 0 2 1 1 0 0 0 0 0 0 0 2 i i i i i i i i i i 0 0 0 0 0 0 0 2 i i i
0 0 0 0 0 0 0 0 0 0 0 0 0 0 0 i i i i i i 1 1 0 0 0 0 0 0 0 0 0 0 2 2 0 0 0 0 0 0 0 2 i i i i i i i i i i 0 0 0 0 0 0 0 2 i i i
0 0 0 0 0 0 0 0 0 0 0 0 0 0 0 i i i i i i 1 1 0 0 0 0 0 0 0 0 0 0 0 0 0 0 0 0 0 0 0 0 0 0 0 0 0 0 0 2 2 2 0 0 0 0 0 0 0 2 i i i
0 0 0 0 0 0 0 0 0 0 0 0 0 0 0 i i i i i i 1 1 0 0 0 0 0 0 0 0 0 0 0 0 0 0 0 0 0 0 0 0 0 0 0 0 0 0 0 0 0 0 0 0 0 0 0 0 0 2 i i i
0 0 0 0 0 0 0 0 0 0 0 0 0 0 0 i i i i i i i 1 0 0 0 0 0 0 0 0 0 2 2 2 0 0 0 0 0 0 0 0 0 0 0 0 0 0 0 0 0 0 0 0 0 0 0 0 0 2 i i i
0 0 0 0 0 0 0 0 0 0 0 0 0 0 0 i i i i i i i 1 2 0 0 0 0 0 0 0 0 i i i 0 0 0 0 0 0 0 0 0 0 0 0 0 0 0 0 0 0 0 0 0 0 0 0 0 2 i i i
0 0 0 0 0 0 0 0 0 0 0 0 0 0 0 i i i i i i i 1 2 0 0 0 0 0 0 0 0 i i i 2 2 2 2 2 2 2 2 2 2 2 0 0 0 0 2 2 2 0 0 0 0 0 0 0 0 i i i
0 0 0 0 0 0 0 0 0 0 0 0 0 0 0 i i i i i i i 1 2 0 0 0 0 0 0 0 0 i i i 1 1 1 1 1 1 1 1 1 1 1 1 1 1 1 1 1 i 0 0 0 0 0 0 0 0 i i i
0 i i i i 0 0 0 0 0 0 0 0 0 0 i i i i i i i 1 2 0 0 0 0 0 0 0 0 i i i 1 1 1 1 1 1 1 1 1 1 1 1 1 1 1 1 1 i 0 0 0 0 0 0 0 0 i i i
0 i i i i 0 0 0 0 0 0 0 0 0 0 i i i i i i i 1 2 0 0 0 0 0 0 0 0 i i i 1 1 1 1 1 1 1 1 1 1 1 1 1 1 1 1 1 i i i i i 0 0 0 0 i i i
0 i i i i 0 0 0 0 0 0 0 0 0 0 i i i i i i i 1 2 0 0 0 0 0 0 0 0 i i i 0 0 0 0 0 0 0 0 0 0 0 0 0 0 0 i i i i i i i 0 0 0 0 i i i
i i i i i 0 0 0 0 0 0 0 2 2 2 i i i i i i i 1 2 2 2 2 0 0 0 0 0 i i i 0 0 0 0 0 0 0 0 0 0 2 2 2 2 2 i i i 2 2 2 2 0 0 0 0 i i i
i i i i i 0 0 0 0 2 i i i i i i i i i i i i i i i i i 2 0 0 0 0 0 0 0 2 2 2 0 0 0 0 0 0 0 1 1 1 1 1 i i i 2 0 0 0 0 0 0 0 i i i
i i i i i 2 0 0 0 2 i i i i i i i i i i i i i i i i i 2 0 0 0 0 0 0 2 1 1 1 0 0 0 0 0 0 0 1 1 1 1 1 i i i 2 0 0 0 0 0 0 0 i i i
0 i i i i 0 0 0 0 0 i i i i i i i i i i i i i i i i i 2 0 0 0 0 0 0 0 1 1 1 0 0 0 0 0 0 0 2 2 2 2 2 i i i 2 0 0 0 0 0 0 0 i i i
0 i i i i 0 0 0 0 0 i i i i i i i i i i i i i i i i i 2 0 0 0 0 0 0 0 1 1 1 0 0 0 0 0 0 0 0 0 0 0 0 i i i 2 0 0 0 0 0 0 0 i i i
0 i i i i 2 0 0 0 2 i i i 0 2 2 2 0 0 0 2 2 0 0 0 2 2 0 0 0 0 0 0 0 0 1 1 1 1 1 1 1 0 0 0 0 0 0 0 0 i i i 0 0 0 0 0 0 0 0 i i i
0 i i i i 2 0 0 0 0 i i i 0 0 0 0 0 0 0 0 0 0 0 0 0 0 0 0 0 0 0 0 0 0 1 1 1 1 1 1 1 0 0 0 0 0 0 0 0 i i i 0 0 0 0 0 0 0 0 i i i
0 i i i i 0 0 0 0 0 i i i 0 0 0 0 0 0 0 0 0 0 0 0 0 0 0 0 0 0 0 0 0 0 1 1 1 1 1 1 1 0 0 0 0 0 0 0 0 i i i 0 0 0 0 0 0 0 0 i i i
i i i i i 0 0 0 0 0 2 2 2 0 0 0 0 0 0 0 0 0 0 0 0 0 0 0 0 0 0 0 0 0 2 1 1 1 0 1 1 1 1 1 1 1 0 0 0 0 i i i 0 0 0 0 i i i i i i i
i i i i i 0 0 0 0 x 0 0 0 0 0 0 0 0 0 0 0 0 0 0 0 0 0 0 0 0 0 0 0 0 2 1 1 1 0 1 1 1 1 1 1 1 0 0 0 0 i i i 0 0 0 0 i i i i i i i
i i i i i 0 0 0 0 0 0 0 0 0 0 0 0 0 0 0 0 0 0 0 0 0 0 0 0 0 0 0 0 0 2 1 1 1 0 1 1 1 2 2 2 2 0 0 0 0 i i i 0 0 0 0 2 2 2 2 i i i
0 i i i i 0 0 0 0 0 0 0 2 2 0 0 0 2 2 0 0 0 0 2 2 0 0 0 0 0 0 0 0 0 0 2 2 2 0 1 1 1 0 0 0 0 0 0 0 0 i i i 0 0 0 0 0 0 0 2 i i i
0 i i i i 0 0 1 1 1 1 1 1 i i i i i i i i i i i i i i 0 0 0 0 0 0 0 0 0 0 0 0 1 1 1 0 0 0 0 0 0 0 0 i i i 0 0 0 0 0 0 0 2 i i i
0 i i i i 0 0 1 1 1 1 1 1 i i i i i i i i i i i i i i 0 0 0 0 0 0 0 0 0 0 0 0 1 1 1 0 0 0 0 0 0 0 0 i i i 0 0 0 0 0 0 0 2 i i i
0 0 0 0 0 0 0 1 1 1 1 1 1 1 1 1 1 1 1 1 1 1 1 1 1 1 1 0 0 i i i i i i i 0 0 0 1 1 1 0 0 0 0 0 0 0 0 i i i 0 0 0 0 0 0 0 2 i i i
0 0 0 0 0 0 0 1 1 1 1 1 1 1 1 1 1 1 1 1 1 1 1 1 1 1 1 0 0 i i i i i i i 0 0 0 1 1 1 0 0 0 0 0 0 0 0 i i i 0 0 0 0 0 0 0 0 i i i
0 0 0 0 0 0 0 0 0 0 0 1 1 1 1 0 0 0 0 1 1 1 1 0 0 0 0 0 0 i i i i i i i 0 0 0 1 1 1 0 0 0 0 1 1 1 1 i i i i i i i 0 0 0 0 i i i
0 0 0 0 0 0 0 0 0 0 0 1 1 1 1 0 0 0 0 1 1 1 1 0 0 0 0 0 0 0 0 i i i 0 0 0 0 0 1 1 1 0 0 0 0 1 1 1 1 i i i i i i i 0 0 0 0 i i i
3 3 3 3 3 3 3 3 3 3 3 1 1 1 1 3 3 3 3 1 1 1 1 3 3 3 3 3 3 3 3 i i i 3 3 3 3 3 1 1 1 0 0 0 0 2 2 2 2 i i i 2 2 2 2 0 0 0 0 i i i
3 3 3 3 3 3 3 3 3 3 3 1 1 1 1 3 3 3 3 1 1 1 1 3 3 3 3 3 3 3 3 i i i 3 3 3 3 3 1 1 1 3 3 3 3 3 3 3 3 i i i 2 0 0 0 0 0 0 0 i i i
3 3 3 3 3 3 3 3 3 3 3 1 1 1 1 3 3 3 3 1 1 1 1 3 3 3 3 3 3 3 3 i i i 3 3 3 3 3 1 1 1 3 3 3 3 3 3 3 3 i i i 2 0 0 0 0 0 0 0 i i i
3 3 3 3 3 3 3 3 3 3 3 1 1 1 1 3 3 3 3 1 1 1 1 3 3 3 3 3 3 3 3 i i i 3 3 3 3 3 1 1 1 3 3 3 3 3 3 3 3 i i i e e e e e e e e i i i