53
gravityswitch 40 down
1 1 1 1 3 3 3 3 3 3 3 3 3 3 3 3 3 3 3 3 3 3 3 3 3 3 3 i i i 3 3 3 3 3 3 3 3 3 3 3 3 1 1 1 0 0 0 3 3 3 3 3 0 0 0 1 1 1 1 i i 0 0 0 0 0 0 0 0 0 0 0 0 0 i i 1 1 1 1 0 0 0 3 3 3 3 3 3
1 1 1 1 3 3 3 3 3 3 3 3 3 3 3 3 3 3 3 3 3 3 3 3 3 3 3 i i i 3 3 3 3 3 3 3 3 3 3 3 3 1 1 1 0 0 0 3 3 3 3 3 0 0 0 1 1 1 1 i i 0 0 0 0 0 0 0 0 0 0 0 0 0 i i 1 1 1 1 0 0 0 3 3 3 3 3 3
1 1 1 1 0 0 0 0 0 0 0 0 0 0 0 0 0 0 0 0 0 0 0 0 0 0 0 i i i 0 0 0 0 0 0 0 0 0 0 0 0 1 1 1 0 0 0 3 3 3 3 3 0 0 0 1 1 1 1 i i 0 0 0 0 0 0 0 0 0 0 0 0 0 i i 1 1 1 1 0 0 0 3 3 3 3 3 3
1 1 1 1 0 0 0 0 0 0 0 0 0 0 0 0 0 0 0 0 0 0 0 0 0 0 0 i i i i i i i 0 0 0 0 0 0 0 0 1 1 1 0 0 0 3 3 3 3 3 0 0 0 1 1 1 1 i i 0 0 0 0 0 0 0 0 0 0 0 0 0 i i 1 1 1 1 0 0 0 3 3 3 3 3 3
1 1 1 1 0 0 0 0 0 0 0 0 0 0 0 0 0 0 0 0 0 0 0 0 0 0 0 i i i i i i i 0 0 0 0 0 0 0 0 1 1 1 0 0 0 3 3 3 3 3 0 0 0 1 1 1 1 i i 0 0 0 0 0 0 x 0 0 0 0 0 0 i i 1 1 1 1 0 0 0 3 3 3 3 3 3
1 1 1 1 2 0 0 0 0 0 2 1 1 1 1 1 1 1 1 0 0 0 0 0 0 0 0 i i i i i i i 0 0 0 0 0 0 0 0 1 1 1 0 0 0 3 3 3 3 3 0 0 0 1 1 1 1 i i 0 0 0 0 0 0 0 0 0 0 0 0 0 i i 1 1 1 1 0 0 0 3 3 3 3 3 3
1 1 1 1 2 0 0 0 0 0 2 1 1 1 1 1 1 1 1 0 0 0 0 0 0 0 0 2 2 2 2 2 2 2 0 0 0 0 0 0 0 0 1 1 1 0 0 0 3 3 3 3 3 0 0 0 1 1 1 1 i i 0 0 0 0 1 1 1 1 1 0 0 0 0 i i 1 1 1 1 0 0 0 3 3 3 3 3 3
1 1 1 1 0 0 0 0 0 0 2 1 i i 1 1 1 1 1 0 0 0 0 0 0 0 0 0 0 0 0 0 0 0 0 0 0 0 0 0 0 0 1 1 1 0 0 0 3 3 3 3 3 0 0 0 1 1 1 1 i 0 0 0 0 0 1 1 1 1 1 0 0 0 0 0 i 1 1 1 1 0 0 0 3 3 3 3 3 3
1 1 1 1 0 0 0 0 0 0 2 1 i i 1 1 1 1 1 2 0 0 0 0 0 0 0 0 0 0 0 0 0 0 0 0 0 0 0 0 0 0 1 1 1 0 0 0 3 3 3 3 3 0 0 0 1 1 1 1 i 0 0 0 0 0 0 1 1 1 0 0 0 0 0 0 i 1 1 1 1 0 0 0 3 3 3 3 3 3
1 1 1 1 0 0 0 0 0 0 0 0 3 3 3 1 1 1 1 2 0 0 0 0 0 0 0 0 0 0 0 0 0 0 0 0 0 0 0 0 0 0 1 1 1 0 0 0 3 3 3 3 3 0 0 0 1 1 1 1 i 0 0 0 0 0 0 0 0 0 0 0 0 0 0 0 i 1 1 1 1 0 0 0 3 3 3 3 3 3
1 1 1 1 2 0 0 0 0 0 0 0 3 3 3 1 1 1 1 0 0 0 0 0 0 0 0 0 0 0 0 0 0 0 0 0 0 0 0 0 0 0 1 1 1 0 0 0 3 3 3 3 3 0 0 0 1 1 1 1 i 0 0 0 0 0 0 0 0 0 0 0 0 0 0 0 i 1 1 1 1 0 0 0 3 3 3 3 3 3
3 3 3 0 0 0 0 0 0 0 0 i i i 3 1 1 1 1 0 0 0 i i i 0 0 0 0 0 0 0 0 0 0 0 0 0 0 0 0 0 1 1 1 0 0 0 3 3 3 3 3 0 0 0 1 1 1 1 i 0 0 0 0 0 0 0 0 0 0 0 0 0 0 0 i 1 1 1 1 0 0 0 3 3 3 3 3 3
3 3 3 0 0 0 0 0 0 0 0 i i i i 1 1 1 1 0 0 0 i i i 0 0 0 0 0 0 0 0 2 1 1 1 1 1 1 1 1 1 1 1 0 0 0 3 3 3 3 3 0 0 0 1 1 1 1 i 0 0 0 0 0 0 0 0 0 0 0 0 0 0 0 i 1 1 1 1 0 0 0 3 3 3 3 3 3
3 3 3 0 0 0 0 0 0 0 0 i i i i 1 1 1 1 0 0 0 i i i 0 0 0 0 0 0 0 0 2 i i i i i i i i 1 1 1 0 0 0 3 3 3 3 3 0 0 0 1 1 1 1 i 0 0 0 0 0 0 0 0 0 0 0 0 0 0 0 i 1 1 1 1 0 0 0 3 3 3 3 3 3
3 3 3 0 0 0 0 0 0 0 0 i i i i 1 1 1 1 0 0 0 i i i 0 0 0 0 0 0 0 0 0 i i i i i i i i 1 1 1 0 0 0 3 3 3 3 3 0 0 0 1 1 1 1 i 0 0 0 0 0 0 0 0 0 0 0 0 0 0 0 i 1 1 1 1 0 0 0 3 3 3 3 3 3
3 3 3 0 0 0 0 0 0 0 0 i i i 3 1 1 1 1 0 0 0 i i i 0 0 0 0 0 0 0 0 0 0 0 0 0 0 0 0 2 1 1 1 1 1 1 1 1 1 1 1 1 1 1 1 1 1 1 i 0 0 0 0 0 0 0 0 0 0 0 0 0 0 0 i 1 1 1 1 1 1 1 1 1 1 1 1 1
3 3 3 0 0 0 0 0 0 0 0 0 3 3 3 1 1 i i i i i i i i 0 0 0 0 0 0 0 0 0 0 0 0 0 0 0 0 2 1 1 1 1 1 1 1 1 1 1 1 1 1 1 1 1 1 1 i 0 0 0 0 0 0 0 0 0 0 0 0 0 0 0 i 1 1 1 1 1 1 1 1 1 1 1 1 1
3 3 3 0 0 0 0 0 0 0 0 0 3 3 3 1 1 i i i i i i i i 0 0 0 0 0 0 0 0 0 0 0 0 0 0 0 0 2 1 1 1 1 1 i 1 1 1 1 1 1 1 1 1 1 1 1 i 0 0 0 0 0 0 0 0 0 0 0 0 0 0 0 i 1 1 1 1 1 1 1 1 1 1 1 1 1
3 3 3 0 0 0 0 0 0 0 0 0 3 3 3 1 1 i i i i i i i i 0 0 0 0 0 0 0 0 0 0 0 0 0 0 0 0 2 1 1 1 1 1 1 1 1 1 1 1 1 1 1 1 1 1 1 1 0 0 0 0 0 0 0 0 0 0 0 0 0 0 0 1 1 1 1 1 1 1 1 1 1 1 1 1 1
3 3 3 0 0 0 0 0 0 0 0 0 3 3 3 1 1 1 i 0 0 0 0 0 0 0 0 0 0 0 0 0 0 0 0 0 0 0 0 0 0 0 0 0 0 0 0 0 2 2 2 2 2 2 0 0 0 0 2 2 2 0 0 0 0 0 0 0 0 0 0 0 0 0 0 0 0 0 0 0 2 2 0 2 2 2 2 2 2 0
3 3 3 0 0 0 0 0 0 0 0 i i i 3 1 1 1 i 0 0 0 0 0 0 0 0 0 0 0 0 0 0 0 0 0 0 0 0 0 0 0 0 0 0 0 0 0 0 0 0 0 0 0 0 0 0 0 0 0 0 0 0 0 0 0 0 0 0 0 0 0 0 0 0 0 0 0 0 0 0 0 0 0 0 0 0 0 0 0
3 3 3 0 0 0 0 0 0 0 0 i i i i 1 1 1 i 0 0 0 0 0 0 0 i i i i i i i i 0 0 0 0 0 0 0 0 0 0 0 0 0 0 0 0 0 0 0 0 0 0 0 0 0 0 0 0 0 0 0 0 0 0 0 0 0 0 0 0 0 0 0 0 0 0 0 0 0 0 0 0 0 0 0 0
3 3 3 0 0 0 0 0 0 0 0 i i i i 1 1 1 i 0 0 0 0 0 0 0 i i i i i i i i 0 0 0 0 0 0 0 0 0 0 0 0 2 2 0 0 0 0 2 2 0 0 0 0 0 0 0 0 0 0 0 0 0 0 0 0 0 0 0 0 0 0 0 0 2 0 0 0 2 2 2 2 2 2 0 0
3 3 3 0 0 0 0 0 0 0 0 i i i i 1 1 1 i 0 0 0 0 0 0 0 i i i i i i i i 0 0 0 0 0 0 0 0 0 0 0 0 i i i i i i i i 0 0 0 0 0 0 0 0 0 0 0 0 0 0 0 0 0 0 0 0 0 0 0 2 1 1 1 1 1 1 1 1 1 1 1 1
3 3 3 0 0 0 0 0 0 0 0 i i i 3 1 1 1 i 0 0 0 0 0 0 0 0 0 i i i i 0 0 0 0 0 0 0 0 0 0 0 0 0 0 i i i i i i i i 0 0 0 0 0 0 0 0 0 0 0 0 0 0 0 0 0 0 0 0 0 0 0 2 1 1 1 1 1 1 1 1 1 1 1 1
3 3 3 0 0 0 0 0 0 0 0 0 3 3 3 1 1 1 i 3 3 3 3 3 3 3 3 3 i i i i 0 0 0 0 0 0 0 0 0 0 0 0 0 0 i i i i i i i i 3 3 3 3 3 3 3 3 3 3 3 3 3 3 3 3 3 3 3 3 3 3 3 3 1 1 1 1 1 1 1 1 1 1 1 1
3 3 3 0 0 0 0 0 0 0 0 0 3 3 3 1 1 1 i 3 3 3 3 3 3 3 3 3 i i i i 0 0 0 0 0 0 0 0 0 0 0 0 0 0 0 0 i i i i 3 3 3 3 3 3 3 3 3 3 3 3 3 3 3 3 3 3 3 3 3 3 3 3 3 3 3 3 3 3 1 1 1 3 3 3 3 3
3 3 3 0 0 0 0 0 0 0 0 0 3 3 3 1 1 1 i 3 3 3 3 3 3 3 3 3 i i i i 0 0 0 0 0 0 0 0 0 0 0 0 0 0 0 0 i i i i 3 3 3 3 3 3 3 3 3 3 3 3 3 3 3 3 3 3 3 3 3 3 3 3 3 3 3 3 3 3 1 1 1 3 3 3 3 3
3 i i i 0 0 0 0 0 0 0 0 3 3 3 1 1 1 i 3 3 3 3 3 3 3 3 3 i i i i 3 3 3 3 3 3 3 3 3 3 3 3 3 3 3 3 i i i i 3 3 3 3 3 3 3 3 3 3 3 3 3 3 3 3 3 3 3 3 3 3 3 3 3 3 3 3 3 3 1 1 1 1 1 1 1 1
i i i i 0 0 0 0 0 0 0 0 3 3 3 1 1 1 i 3 3 3 3 3 3 3 3 3 i i i i 3 3 3 3 3 3 3 3 3 3 3 3 3 3 3 3 i i i i 3 3 3 3 3 3 3 3 3 3 3 3 3 3 3 3 3 3 3 3 3 3 3 3 3 3 3 3 3 3 1 1 1 1 1 1 1 1
i i i i 0 0 0 0 0 0 0 0 3 3 3 1 1 1 i 3 3 3 3 3 3 3 3 3 i i i i 3 3 3 3 3 3 3 3 3 3 3 3 3 3 3 3 i i i i 3 3 3 3 3 3 3 3 3 3 3 3 3 3 3 3 3 3 3 3 3 3 3 3 3 3 3 3 3 3 1 1 1 1 1 1 1 1
i i i i 0 0 0 0 0 0 0 i i i 3 1 1 1 i 3 3 3 3 3 3 3 3 3 i i i i 3 3 3 3 3 3 3 3 3 3 3 3 3 3 3 3 i i i i 3 3 3 3 3 3 3 3 3 3 3 3 3 3 3 3 3 3 3 3 3 3 3 3 3 3 3 3 3 3 1 1 1 3 3 3 3 3
3 i i i 0 0 0 0 0 0 0 i i i i 1 1 1 i 3 3 3 3 3 3 3 3 3 i i i i 3 3 3 3 3 3 3 3 3 3 3 3 3 3 3 3 i i i i 3 3 3 3 3 3 3 3 3 3 3 3 3 3 3 3 3 3 3 3 3 3 3 3 3 3 3 3 3 3 1 1 1 3 3 3 3 3
3 3 3 0 0 0 0 0 0 0 0 i i i i 1 1 1 i 3 3 3 3 3 3 3 3 3 i i i i 3 3 3 3 3 3 3 3 3 3 3 3 3 3 3 3 i i i i 3 3 3 3 3 3 3 3 3 3 3 3 3 3 3 3 3 3 3 3 3 3 3 3 3 3 3 3 3 3 1 1 1 3 3 3 3 3
3 3 3 0 0 0 0 0 0 0 0 i i i i 1 1 1 i 3 3 3 3 3 3 3 3 3 i i i i 3 3 3 3 3 3 3 3 3 3 3 3 3 3 3 3 i i i i 3 3 3 3 3 3 3 3 3 3 3 3 3 3 3 3 3 3 3 3 3 3 3 3 3 3 3 3 3 3 1 1 1 3 3 3 3 3
3 3 3 e e e e e e e e i i i 3 1 1 1 i 3 3 3 3 3 3 3 3 3 i i i i 3 3 3 3 3 3 3 3 3 3 3 3 3 3 3 3 i i i i 3 3 3 3 3 3 3 3 3 3 3 3 3 3 3 3 3 3 3 3 3 3 3 3 3 3 3 3 3 3 1 1 1 3 3 3 3 3